First Room Ever

....................
.#####..............
.#...#..............
.#...#..............
.#...#..............
.#####..............
....................
...............#H###
................H...
................H...
................H...
####################
####################
####################

2,10 player
0,10 warp room1@18,10